Ay,Kâr/Zarar (USD),Trade Sayısı,Başarı Oranı (%),TP İşlem,SL İşlem
2024-04,700.25,13,61.54,8,5
2024-05,85.03,9,44.44,4,5
2024-06,1169.33,7,100.0,7,0
2024-07,-435.95,16,31.25,5,11
2024-08,2153.33,20,75.0,15,5
2024-09,688.58,10,60.0,6,4
2024-10,-2.5,5,40.0,2,3
2024-11,-592.7,19,31.58,6,13
2024-12,1704.05,23,60.87,14,9
2025-01,2536.28,17,76.47,13,4
2025-02,338.97,13,46.15,6,7
2025-03,-208.42,11,36.36,4,7
Toplam/Ort,8136.25,163,55.21472392638037,90,73
