Ay,Kâr/Zarar (USD),Trade Sayısı,Başarı Oranı (%),TP İşlem,SL İşlem
2024-04,720.68,15,53.33,8,7
2024-05,52.28,7,42.86,3,4
2024-06,1697.33,10,80.0,8,2
2024-07,66.97,12,41.67,5,7
2024-08,2705.77,19,68.42,13,6
2024-09,1033.45,8,62.5,5,3
2024-10,106.37,7,42.86,3,4
2024-11,-1125.77,17,29.41,5,12
2024-12,2372.15,20,60.0,12,8
2025-01,4186.89,13,84.62,11,2
2025-02,1979.83,14,57.14,8,6
2025-03,-938.17,10,30.0,3,7
Toplam/Ort,12857.779999999999,152,55.26315789473685,84,68
